N 50
M 20
P P P P P P P P P P P P P P P P P P P P 
P L L L L L L L L L L L L L L L L L L P 
P L L L L L L L L L L L L L L L L L L P 
P L L L L L L L L L L L L L L L L L L P 
P L L L L L L L L L L L L L L L L L L P 
P L L L L L L L L L L L L L L L L L L P 
P L L L L L L L L L L L L L L L L L L P 
P L L L L L L L L L L L L L L L L L L P 
P L L L L L L L L L L L L L L L L L L P 
P L L L L L L L L L L L L L L L L L L P 
P L L L L L L L L L L L L L L L L L L P 
P L L L L L L L L L L L L L L L L L L P 
P L L L L L L L L L L L L L L L L L L P 
P L L L L L L L L L L L L L L L L L L P 
P L L L L L L L L L L L L L L L L L L P 
P L L L L L L L L L L L L L L L L L L P 
P L L L L L L L L L L L L L L L L L L P 
P L L L L L L L L L L L L L L L L L L P 
P L L L L L L L L L L L L L L L L L L P 
P L L L L L L L L L L L L L L L L L L P 
P L L L L L L L L L L L L L L L L L L P 
P L L L L L L L L L L L L L L L L L L P 
P L L L L L L L L L L L L L L L L L L P 
P L L L L L L L L L L P P P P P P P P P 
P L L L L L L L L L L P P P P P P P P P 
P P L L L L L P L L L P P P P P P P P P 
P P L L L L L L L L L P P P P P P P P P 
P P P L L L L L P P P P P P P P P P P P 
P P P L L P L L P P P P P P P P P P P P 
P P P L L L L L P P P P P P P P P P P P 
P P P P P L P P P P P P P P P P P P P P 
P P P P P L P P P P P P P P P P P P P P 
P P P P P L L L L L L L L L P P P P P P 
P P P P P L L L L L L L L L P P P P P P 
P P P P P P P P L P P P P P P P P P P P 
P P P P P P P P L P P P P P P P P P P P 
P P P P P P P P L L L L L L P P P P P P 
P P P P P P P P P P P L L L P P P P P P 
P P P L L L L L L P P L L L P P P P P P 
P P P L P P P P L P P L L L P P P P P P 
P P P L L L L L L L L L L L P P P P P P 
P P P P P L P P P P P P P P P P P P P P 
P P P P P L P P P P P P P P P P P P P P 
P P P P P L L L L L L L L L P P P P P P 
P P P P P L L L L L L L L L P P P P P P 
P P P P P L L L L L L L L L L L L L L P 
P L L L L L L L J L L L L L L L L L L P 
P L L L L P P P P P P P P P P L L L L P 
P L L L L L L L L L L L L L L L L L L P 
P P P P P P P P P P P P P P P P P P P P 
