N 34
M 20
P P P P P P P P P P P P P P P P P P P P 
P P P P P P P P P P P P P P P P P P P P 
P P P P P P P P P P P P P P L P P P P P 
P P P P P P P P P P P P P P L P P P P P 
P P P P P P P P P P P P P P L P P P P P 
P P P P P P P P P P P P P P L P P P P P 
P P P P P P P P P P P P P P L P P P P P 
P P P P P P P P P P P P P P L P P P P P 
P P P P P P P P P P L L L L L P P P P P 
P P P P P P P P P P L L L P P P P P P P 
P P P P P P P P P P L L L P P P P P P P 
P P P L L L L L P P L L L L P P P P P P 
P P L P P P P P P P P P P L P P P P P P 
P L P P P P P P P P P P P L P P P P P P 
P L P P P P P P P P P P P L P P P P P P 
P P L P P P P P P P P P P L P P P P P P 
P P P L L L L P P P P P P L P P P P P P 
P P P P P P P L P P P L L L L L L P P P 
P P P P P P P P L P P L L L P P L P P P
P P P P P P P P L P P L L L P P L P P P 
P P P P P P P L P P P L L L P P L P P P 
P P L L L L L L P P P P P P P P L P P P 
P P P P P P P P P P P P P P P P L P P P 
P P P P P P L L L L L P P P P P L P P P 
P P P P P P L P P P L P P P P P L P P P 
P P P P P P L P P P L L L L L L L P P P 
P P P P P P L P P P P P P P P P P P P P 
P P P P P P L P P P P P P P P P P P P P 
P L L L L L L L L L L L P P P L L L L P 
P L L L L L L P P P P L L L L L L L L P 
P L L L L L L P P P P P P P P P L L L P 
P L L L L L L P P P P P P P L L L L L P 
P L L L L L L P P P P P P P L J L L L P 
P P P P P P P P P P P P P P P P P P P P 
